1111111111
1111111E11
1111111C11
1111111P11
1111111B11
1111111111
1111111111