1111111111111111111
100000000000000000E
10000000P0000000001
10000000000000C0001
100P000000000000001
1111111111111111111
