1111111111111111111111111111111111111
1000000000000000000C00000000000000001
1000000000000000000C00000000000001111
100000000B000000000C00000000000000001
1000000000000000000C00000000000000001
1000000000000000000C00000000000000001
1000000000000000000C00000000000000001
1000000000000P00000C0000000B000000001
1000000000000000000C00000000000000001
1000000000000000000C000000000000000E1
1111111111111111111111111111111111111