11111111111111111111111111111111
100000000000000000000E0000000001
1000P000010000000000000000000011
100C000001000000C000000000000001
11111011111111111100000000000001
10000010000000000000000000000001
100C0010000000000100000000000001
100000000000C000010000B000000001
11111111111111111111111111111111
