11111111111111111111111
10000000000000000000001
10000000010000E00000001
100000P0010000000000001
11111111111111111100001
10000010000000000000001
10000010000000000100001
100000000C0000000100001
11111111111111111111111
