11111111111111111111111111111111
12000000000000P00000000000000001
1L000000010000000000000000000001
14000000010000000000000000000001
15111111111111111100000000000001
16000010000000000000000000000001
170000100000B0000100000000000001
180000000C0000000100000000000001
11111111111111111111111111111111
