11111111111111111111111111111111
100000000000000000000E0000000001
1000P000010000000000000000000011
1000000001000000C000000000000001
11111111111111111100000000000001
10000010000000000000000000000001
100000100000B0000100000000000001
10000000000000000100000000000001
11111111111111111111111111111111
