11111111111111
100B0000P00111
10111111111111
100C000000E011
1111111111111