11111111111111
10000000P00111
10111111111111
10000000000011
11111111111111