11111111111111111111111111111111111111111111
1E000001000000000000000000000000000000000C11
10000001000000000111111110001000000000000011
10000001000000000100000000001111111111111111
10000001000000000100111111111000000000000011
10000000000000000000000000000000000000000011
11111111111111111111111111111111111111100111
10000000000000000000000000000000000000000011
100000B0000000000000000000000000000000000C11
10000000111111111111111111111111111111111111
10000000000000000000000000000000000000000P11
11111111111111111111111111111111111111111111
11111111111111111111111111111111111111111111