1111111
1000001
1000001
1000001
1000001
10000E1
1BC0001
10000P1
1111111