1111111
1000001
1000B01
1000C01
1000001
1000E01
10C0001
1000001
1111111